NO      textures/1080x1080.xpm



                          SO        textures/1080x1080.xpm
  EA textures/1080x1080.xpm
WE textures/1080x1080.xpm

C 12, 4    ,122      

  F               1,2,3

111111
100N11
111111
