NO      textures/11111.xpm



                          SO        asljcnasc.xpm
  EA textures/resim1.xpm
WE resim1.xpm

C 12, 4    ,122      

  F               1,2,3
1111
1N01 
1111

