NO      textures/BrickGrey.xpm



                          SO        textures/BrickGrey.xpm
  EA textures/BrickGrey.xpm
WE textures/BrickGrey.xpm

C 12, 4    ,122      

  F               1,2,3

111111
100001
100001
1S0001
111111




    